12 6
1p000000@000
101011211111
00101001@01s
011010010110
01t110110000
0001@0000@00