12 6
1p@000000000
101011211111
00101001001s
011010010110
01t11@110000
000100000@00