8 6
#p@00000
#0#0##0#
00#0#000
0##0#0#0
0#00#@#0
000#000s